____________
____________
_____K_Y_G__
___Y___G____
_O_P______Q_
___R_OQ_____
____P_ARK___
_D__D_W_____
__________W_
__B_______B_
__________A_
____________
